
WE         textures/greendragon64.xpm
  C      25,    30,		200
	
EA textures/treeolife64.xpm
	
	S    sprites/ghost.xpm
  R   1000   	800

	NO    textures/celestial64.xpm

  F      25  ,   105,    50


SO textures/flower64.xpm




        11111111111111111111111
       1111000000011000000000011111
        101120  00000220022002001
        1001200000000020000  0201
111111111000000001110000000000001
120000000000000000000000000011111
11100011111111111100000010001
 1110111111111011101010010201
11000000110101011100000010001
100200000   00001100000000001
10020000000000001101010010N01
1100010111010101111101111000111
11110111 1110101  100111010001
  111111 1111111  111111111111


