
WE         textures/balrog64.xpm
  C  10,    30,110
	
EA textures/brush64.xpm
	
	S    sprites/sky.xpm
  R   1024   	720

	NO    textures/fire64.xpm

  F        120   ,   50,     60


SO textures/lava64.xpm





        1111111111111111111111111
        1000000110000100002001001
        1000000100000000200001001
        1000200100000111110000001
111111111000000001000001000000001
100000010000002001001101000011111
10000011100000000002000100001
10001000000200011000010001111
1000100000000001100101000000111
10020111110001001000010020001
10000000000001000001010000N01
11000001110101011111011110101
11110111 1110101 101111010001
11111111 1111111 111111111111


